                                                                                
                                                                                
                                                                                
                                                                                
                                                                                
                                                                                
                                                                                
                                                                                
                                                                                
                                                                                
                                                                                
            ◢█████████████◣                                                     
            ███████████████                                                     
            ███████████████                                                     
            ███████████████                                                     
            ███████████████                                                     
            ███████████████                                                     
            ███████████████                                                     
            ███████████████                                                     
            ███████████████                                                     
            ███████████████                                                     
            ███████████████                                                     
            ███████████████                                                     
            ◥█████████████◤                                                     
                                                                                
                                                                                
        ███                      ███                                            
        ███                      ███                                            
        ███                      ███                                            
        ███   ◢██████████████◣   ███                                            
        ███   ████████████████   ███                                            
        ███   ████████████████   ███                                            
        ███   ████████████████   ███                                            
        ███   ████████████████   ███                                            
        ███   ████████████████   ███                                            
        ███   ████████████████   ███                                            
        ███   ████████████████▄▄▄███                                            
        ███   ████████████████   ███                                            
        ███   ████████████████   ███                                            
        ███▄▄▄████████████████   ███                                            
        ███   ████████████████   ███                                            
        ███   ████████████████   ███                                            
        ███▄▄▄████████████████▄▄▄███                                            
        ███   ████████████████   ███                                            
        ███   ████████████████   ███                                            
