                                                                                                                                                                                                        
                                                                                                                                                                                                        
                                                                                                                                                                                                        
                                                                                                                                                                                                        
                                                                                                                                                                                                        
                                                                                                                                                                                                        
                                                                                                                                                                                                        
                                                                                                                                                                                                        
                                                                                                                                                                                                        
                                                                                                                                                                                                        
                                                                                                                                                                                                        
                                                                                                                                                                                                        
                                                                                                                                                                                                        
                                                                                                                                                                                                        
                                                                                                                                                                                                        
                                                                                                                                                                                                        
                                                                                                                                                                                                        
                                                                                                                                                                                                        
                                                                                                                                                                                               ███      
                                                                                                                                                                                            ███████████ 
                                                                                                                                                                                         ███████████████
                                                                                                                                                                                       █████████████████
                                                                                                                                                                                     ███████████████████
                                                                                                                                                                                   █████████████████████
                                                                                                                                                                                  ██████████████████████
                                                                                                                                                                                 ███████████████████████
                                                                                                                                                                                ████████████████████████
                                                                                                                                                                               █████████████████████████
                                                                                                                                                                              ██████████████████████████
                                                                                                                                                                             ▐██████████████████████████
                                                                                                                                                                             ▐██████████████████████████
                                                                                                                                                                             ███████████████████████████
███▌                                                                                                                                                                        ▐███████████████████████████
████                                                                                                                                                                        ▐███████████████████████████
████▌                                                                                                                                                                       ▐███████████████████████████
████▌                                                                                                                                                                       ████████████████████████████
█████▌                                                                                                                                                                      ████████████████████████████
██████                                                                                                                                                                     ▐████████████████████████████
██████▌                                                                                                                                                                    ▐████████████████████████████
██████▌                                                                                                                                                                    ▐████████████████████████████
███████                                                                                                                                                                    ▐████████████████████████████
███████                                                                                                                                                                    ▐████████████████████████████
███████▌                                                                                                                                                                   ▐████████████████████████████
███████▌                                                                                                                                                                   █████████████████████████████
███████▌                                                                                                                                                                   █████████████████████████████
████████                                                                                                                                                                   █████████████████████████████
████████                                                                                                                                                                   █████████████████████████████
████████                                                                                                                                                                   █████████████████████████████
████████                                                                                                                                                                   █████████████████████████████
████████                                                                                                                                                                   █████████████████████████████
████████                                                                                                                                                                  ▐█████████████████████████████
████████▌                                                                                                                                                                 ▐█████████████████████████████
████████▌                                                                                                                                                                 ▐█████████████████████████████
████████▌                                                                                                                                                                 ▐█████████████████████████████
████████▌                                                                                                                                                                 ▐█████████████████████████████
████████▌                                                                                                                                                                 ▐█████████████████████████████
█████████                                                                                                                                                                 ▐█████████████████████████████
█████████                                                                                                                                                                 ▐█████████████████████████████
█████████                                                                                                                                                                 ▐█████████████████████████████
█████████                                                                                                                                                                 ██████████████████████████████
█████████                                                                                                                                                                 ██████████████████████████████
█████████▌                                                                                                          ▄█████████████▄▄                                     ▐██████████████████████████████
█████████▌                                                                                                       ▄████████████████████▄                                  ▐██████████████████████████████
█████████▌                                                                                                      ████████████████████████                                 ▐██████████████████████████████
█████████▌                                                                                                   ▄▄██████████████████████████                                ███████████████████████████████
█████████▌                                                                                                  ██████████████████████████████                              ████████████████████████████████
█████████▌                                                                                                 ████████████████████████████████                             ████████████████████████████████
██████████                                                                                                 █████████████████████████████████                           ▄████████████████████████████████
██████████                                                                                                ███████████████████████████████████                         ██████████████████████████████████
██████████◣                                                                                               ████████████████████████████████████                      ▄███████████████████████████████████
███████████                                                                                              ██████████████████████████████████████                   ▄█████████████████████████████████████
███████████◣                                                                                             ███████████████████████████████████████                ▄███████████████████████████████████████
████████████                                                                                             ██████████████████████████████████████████         ▄▄▄█████████████████████████████████████████
████████████◣                                                                                           ██████████████████████████████████████████████▄  ▄██████████████████████████████████████████████
█████████████                                                                                          █████████████████████████████████████████████████████████████████████████████████████████████████
█████████████◣                                                                                        ██████████████████████████████████████████████████████████████████████████████████████████████████
██████████████                                                                                     ▄▄███████████████████████████████████████████████████████████████████████████████████████████████████
██████████████◣                                                                               ▄▄▄▄██████████████████████████████████████████████████████████████████████████████████████████████████████
███████████████▆▄▄                                                                      ▄▄▄█████████████████████████████████████████████████████████████████████████████████████████████████████████████
████████████████████▆▄▄                                                            ▄▄▄██████████████████████████████████████████████████████████████████████████████████████████████████████████████████
██████████████████████████▆▄▄▄                                                  ▄███████████████████████████████████████████████████████████████████████████████████████████████████████████████████████
████████████████████████████████▆▄▄                                           ▄█████████████████████████████████████████████████████████████████████████████████████████████████████████████████████████
██████████████████████████████████████▆▄▄▄▄▄▄▄▄▄▄                           ▄███████████████████████████████████████████████████████████████████████████████████████████████████████████████████████████
█████████████████████████████████████████████████████████████◣           ▄▄█████████████████████████████████████████████████████████████████████████████████████████████████████████████████████████████
███████████████████████████████████████████████████████████████◣       █████████████████████████████████████████████████████████████████████████████████████████████████████████████████████████████████
████████████████████████████████████████████████████████████████       █████████████████████████████████████████████████████████████████████████████████████████████████████████████████████████████████
████████████████████████████████████████████████████████████████       █████████████████████████████████████████████████████████████████████████████████████████████████████████████████████████████████
████████████████████████████████████████████████████████████████      ▗█████████████████████████████████████████████████████████████████████████████████████████████████████████████████████████████████
████████████████████████████████████████████████████████████████      ██████████████████████████████████████████████████████████████████████████████████████████████████████████████████████████████████
████████████████████████████████████████████████████████████████      ██████████████████████████████████████████████████████████████████████████████████████████████████████████████████████████████████
████████████████████████████████████████████████████████████████◣     ██████████████████████████████████████████████████████████████████████████████████████████████████████████████████████████████████
█████████████████████████████████████████████████████████████████     ██████████████████████████████████████████████████████████████████████████████████████████████████████████████████████████████████
█████████████████████████████████████████████████████████████████◣    ██████████████████████████████████████████████████████████████████████████████████████████████████████████████████████████████████
██████████████████████████████████████████████████████████████████◣  ▗██████████████████████████████████████████████████████████████████████████████████████████████████████████████████████████████████
███████████████████████████████████████████████████████████████████  ███████████████████████████████████████████████████████████████████████████████████████████████████████████████████████████████████
███████████████████████████████████████████████████████████████████ ▗███████████████████████████████████████████████████████████████████████████████████████████████████████████████████████████████████
███████████████████████████████████████████████████████████████████▗████████████████████████████████████████████████████████████████████████████████████████████████████████████████████████████████████
████████████████████████████████████████████████████████████████████████████████████████████████████████████████████████████████████████████████████████████████████████████████████████████████████████
████████████████████████████████████████████████████████████████████████████████████████████████████████████████████████████████████████████████████████████████████████████████████████████████████████
████████████████████████████████████████████████████████████████████████████████████████████████████████████████████████████████████████████████████████████████████████████████████████████████████████
